111111
100C01
100P01
110E01
111111
