111111
100P01
100C01
110E01
111111
