11111111111
10P0C0E1001
11111111111
