11111111111
10P0C1E1001
11111111111
