111111111111111111111111111111111111111111111111111111111111111111111111111111111111111
100000000000000000000000000000000000000000011111111111000000000000000000000000000000001
100000000000000000000000000000000000000000000111100000000000000000000000000000000000011
100000000000000000000000000000000000000000000110000000000000000000000000000000000000111
110000000000000000000000000000000000000000000100000000000000000000000000000000000001111
111000000000000C00000000000000000000000000000000000000000000000000000000000000000011111
1100000000000000000000000000C0000000000011100000000000000000000000000000000000000001111
10000000000000000000000000001000000000001C10000000000000000000E000000000000000000000111
100000000000000000000000000000111000000000100000000000000000000000000000000000000000001
111000000000000000000000000000000000000000000000000000000000000000000000000000000000001
111110000000000000000000000P0000000000000000000000000000000000000C000000000000000000001
111111111111111111111111111111111111111111111111111111111111111111111111111111111111111
